3333333333333333
3111000004444443
3111000004222243
3111000004222443
3000000004444403
3000000000000003
3000010000000003
3010003000000003
3000033300001113
3001003000001113
3000000000001113
3333333333333333